███   ███   ███
███▄▄▄▀▀▀▄▄▄▀▀▀
██████   ███
██████   ███
███▀▀▀▄▄▄▀▀▀▄▄▄
███   ███   ███
      █████████
▄▄▄▄▄▄▀▀▀▀▀▀▀▀▀
██████