                      _________________________
                     │░░░░░░░░░░░╱ ╲░░░░░░░░░░░│
███   ███   ███      │░░░░░░░░░░╱   ╲░░░░░░░░░░│
███▄▄▄▀▀▀▄▄▄▀▀▀      │░░░░░░░░░╱     ╲░░░░░░░░░│
██████   ███         │░░░░░░░░╱◯     ◯╲░░░░░░░░│
██████   ███         │░░░░░░░╱ │ ◯ ◯ │ ╲░░░░░░░│
███▀▀▀▄▄▄▀▀▀▄▄▄      │░░░░░░╱  └─┤ ├─┘  ╲░░░░░░│
███   ███   ███      │░░░░░╱ ◯───┼─┼───◯ ╲░░░░░│
      █████████      │░░░░╱    ◯─┼─┼─◯    ╲░░░░│
▄▄▄▄▄▄▀▀▀▀▀▀▀▀▀      │░░░╱     ┌─┤ ├─┐     ╲░░░│
██████               │░░╱      │ ◯ ◯ │      ╲░░│
                     │░╱       ◯     ◯       ╲░│
