 _________________________
│░░░░░░░░░░░╱ ╲░░░░░░░░░░░│
│░░░░░░░░░░╱   ╲░░░░░░░░░░│
│░░░░░░░░░╱     ╲░░░░░░░░░│
│░░░░░░░░╱◯     ◯╲░░░░░░░░│
│░░░░░░░╱ │ ◯ ◯ │ ╲░░░░░░░│
│░░░░░░╱  └─┤ ├─┘  ╲░░░░░░│
│░░░░░╱ ◯───┼─┼───◯ ╲░░░░░│
│░░░░╱    ◯─┼─┼─◯    ╲░░░░│
│░░░╱     ┌─┤ ├─┐     ╲░░░│
│░░╱      │ ◯ ◯ │      ╲░░│
│░╱       ◯     ◯       ╲░│